Nombre del Barrio o Colonia,Vivendas con 0 NBI,Vivendas con 1 NBI,Vivendas con 2 NBI,Vivendas con 3 NBI,Vivendas con 4+ NBI,total,rank,avrg
ZONA INDUSTRIAL  CAPRISA,0,0,0,0,2,2,8,4
TRAMO RES. EL MOLINONCOL. LOMA,0,0,0,0,1,1,4,4
COL. GENERACION 2000,0,2,2,51,104,159,575,3.616352201
BO. EL MANZANAL,1,0,3,4,26,33,122,3.696969697
BO.ALTOS DEL EDEN,0,0,1,0,3,4,14,3.5
BO. LA ISLA,0,0,2,9,14,25,87,3.48
COL. SANTA CLARA,4,3,2,54,68,127,441,3.472440945
BO.LA PEDRERA NO.2,0,1,1,2,7,11,37,3.363636364
COL. LOMAS DEL MOLINO,4,0,1,6,22,29,108,3.724137931
COL. LA LIBERTAD 2 O CIUDAD PICHETE,0,1,21,73,67,162,530,3.271604938
COL. BERLIN,5,23,6,103,124,256,840,3.28125
COL NUEVA CAPITAL,1,197,111,1214,1015,2537,8121,3.201024832
COL.MARY DE FLORES,0,45,22,251,193,511,1614,3.15851272
ALDEA LA SOLEDAD,2,30,11,81,108,230,727,3.160869565
COL. CIUDAD GUZMAN,14,8,3,63,73,147,495,3.367346939
COL. JOSE TRINIDAD CABAÑAS,1,14,2,52,36,104,318,3.057692308
BRISAS DE ORIENTE,10,15,29,111,75,230,706,3.069565217
COL. ALTOS DE AGAFAM,2,0,25,21,26,72,217,3.013888889
UNION Y FUERZA,12,87,66,247,192,592,1728,2.918918919
COL. ALTOS DE LAS CASCADAS,19,15,6,33,72,126,414,3.285714286
COL. F. CALDERON,2,1,5,10,8,24,73,3.041666667
COL. BUENA VISTA,20,34,7,157,78,276,831,3.010869565
NUEVA JERUSALEN,24,116,32,252,149,549,1532,2.790528233
COL. ALTOS DE LA LAGUNA,49,31,10,127,109,277,868,3.133574007
COL. FLORES DE ORIENTE,26,10,231,175,129,545,1513,2.776146789
COL. MONTE DE LOS OLIVOS,28,74,27,182,83,366,1006,2.74863388
COL. RAMON AMAYA AMADOR NO.1,1,5,4,5,7,21,56,2.666666667
COL. ALTOS DE CENTROAMERICA,13,93,29,162,73,357,929,2.602240896
COL. SAN JUAN DEL NORTE NO. 2,12,7,170,113,36,326,830,2.54601227
COL. FUERZAS UNIDAS,73,42,299,246,154,741,1994,2.690958165
CASERIO EL MOGOTE,4,0,29,10,11,50,132,2.64
COL. MOLOLOA O ALTOS DE LA SOS,36,63,69,99,99,330,894,2.709090909
COL. RES. LOMA ALTA,2,1,0,5,2,8,24,3
COL. FRANCISCO MORAZAN,22,25,81,76,43,225,587,2.608888889
"COL. VILLA CRISTINA ( ETAPA I, II,",187,66,380,327,286,1059,2951,2.786591124
RESIDENCIAL NUEVA AUSTRALIA,49,32,123,93,84,332,893,2.689759036
COL. LOS PINOS,357,250,871,800,548,2469,6584,2.666666667
COL.ARCIERI NO.2,10,6,70,50,11,137,340,2.481751825
COL. NUEVA ESPAÑA,33,14,150,98,41,303,772,2.547854785
COL. LOS QUEBRACHITOS,58,49,63,96,85,293,803,2.740614334
RES. VILLAS ROBLES,1,1,2,1,2,6,16,2.666666667
COL. ALTOS DE LA QUEZADA,11,9,11,17,16,53,146,2.754716981
COL. TIERRA BLANCA,26,47,20,69,41,177,458,2.587570621
BO. LA CUESTA NO. 1,68,17,167,135,60,379,996,2.627968338
COL. NUEVA SUYAPA,153,38,643,359,127,1167,2909,2.492716367
COL.ALTOS DEL PARAISO NO.2,10,2,20,15,9,46,123,2.673913043
COL. JOSE ANGEL ULLOA ( SECTOR 1 AL,157,77,565,302,167,1111,2781,2.503150315
COL. 14 DE FEBRERO,14,8,55,26,16,105,260,2.476190476
CERRO JUAN A. LAINES,26,20,22,28,33,103,280,2.718446602
COL. LAS PAVAS,30,13,151,82,16,262,625,2.385496183
COL. LAS VEGAS DEL LA FLOR DEL CAMP,37,34,35,34,49,152,402,2.644736842
COL.RAMON AMAYA AMADOR NO2,123,206,272,256,162,896,2166,2.417410714
COL. CANAAN,217,99,303,245,211,858,2284,2.662004662
COL.LA LEONESA DEL RINCON,17,12,8,22,16,58,158,2.724137931
COL. BRISAS DE LA LAGUNA,12,6,38,23,8,75,183,2.44
RES. VILLA LOS LAURELES,7,3,7,6,7,23,63,2.739130435
COL. LOMITAS DE SUYAPA,20,39,20,41,20,120,282,2.35
LOS OLIVOS,0,0,1,0,0,1,2,2
COL. BRISAS DE SUYAPA,37,12,164,67,8,251,573,2.282868526
COL. LINDA VISTA,24,26,12,28,22,88,222,2.522727273
COL. 17 DE SEPTIEMBRE SECTOR NO.1,46,16,85,56,23,180,446,2.477777778
COL.MONTES DE BENDICION,82,31,100,78,51,260,669,2.573076923
FALDAS RES. CENTROAMERICA ESTE,22,5,33,22,10,70,177,2.528571429
COL. ALTOS DEL PARAISO,222,87,410,232,109,838,2039,2.433174224
INVASION AL OESTE DE CERRO GRANDE IV ETAPA,12,18,20,20,8,66,150,2.272727273
ZONA PUENTE DE LOARQUE,8,0,8,6,4,18,50,2.777777778
COL. JOSE ARTURO DUARTE ( SECTOR 1,165,45,300,163,76,584,1438,2.462328767
COL. LA LIBERTAD,18,6,54,19,7,86,199,2.313953488
BO. BUENA VISTA,25,10,1,20,16,47,136,2.893617021
COL. NUEVA DANLI,109,40,266,111,35,452,1045,2.311946903
COL. VILLA NUEVA NORTE,799,346,1317,797,314,2774,6627,2.388968998
COL. NUEVA GALILEA,23,11,41,20,10,82,193,2.353658537
COL. 17 DE SEPTIEMBRE,43,24,82,30,23,159,370,2.327044025
COL. LOMAS DEL MAYAC O PROFESIONALE,122,19,116,79,48,262,680,2.595419847
CASERIO LA CAÑADA,58,26,54,46,22,148,360,2.432432432
COL. BUENAS NUEVAS,62,23,87,49,18,177,416,2.350282486
COL. VILLA FRANCA,238,136,299,190,86,711,1648,2.317862166
COL. JERUSALEN NO. 2,17,11,5,9,11,36,92,2.555555556
COL. OJO DE AGUA,57,67,30,38,38,173,393,2.271676301
COL.ARCIERI,95,34,90,74,27,225,544,2.417777778
BO. SALIDA DEL SUR,13,5,7,3,8,23,60,2.608695652
COL. CONTINENTAL,19,10,10,18,4,42,100,2.380952381
ALDEA SUYAPA,430,142,272,244,149,807,2014,2.495662949
COL. BRISAS DEL MOGOTE,16,10,11,11,5,37,85,2.297297297
COL. VILLA NUEVA SUYAPA,590,192,740,372,96,1400,3172,2.265714286
COL. NUEVA JAPON,6,11,0,6,3,20,41,2.05
COL. SAN JUAN DEL NORTE NO.1,26,9,37,18,2,66,145,2.196969697
COL. PLAN  DE LOS PINOS,116,56,80,71,33,240,561,2.3375
COL. EL MIRADOR,7,4,2,7,1,14,33,2.357142857
COL.DAVID BETANCOURT,76,20,92,40,13,165,376,2.278787879
COL. LOMAS DE CIUDAD LEMPIRA,45,42,35,24,16,117,248,2.11965812
BOL. EL ZANCUDO,122,53,130,60,25,268,593,2.212686567
COL. RIVERA DE LA VEGA,70,38,28,39,22,127,299,2.354330709
ALDEA LA CAÑADA,136,151,51,94,48,344,727,2.113372093
KUWAIT,55,39,50,29,14,132,282,2.136363636
TRAMO COL. JARDINES DEL NORTE,1,0,0,1,0,1,3,3
COL. ALTOS DE CANTERO,32,7,15,19,6,47,118,2.510638298
COL. GEREZIN,27,16,9,5,14,44,105,2.386363636
COL. SOTO,143,93,61,30,70,254,585,2.303149606
COL. EL CASTAÑO SUR,171,17,77,56,48,198,531,2.681818182
RES. VILLA LOS GERANEOS,8,1,0,6,1,8,23,2.875
BO. LA PRIMAVERA,31,12,49,9,3,73,149,2.04109589
RES. VILLAS BRASIL,5,1,6,1,1,9,20,2.222222222
COL. VILLA NUEVA SUR,1556,697,1249,623,292,2861,6232,2.17825935
COL. VILLA ESTANZUELA O BARRIO NUEVO,77,36,43,31,18,128,287,2.2421875
BO. LA BOLSA,23,11,1,3,12,27,70,2.592592593
COL. VISTA HERMOSA LOARQUE),57,52,29,19,18,118,239,2.025423729
PASEO O FINCA LOS LAURELES,33,21,8,9,12,50,112,2.24
RES. VILLAS DEL PINO,24,6,12,10,3,31,72,2.322580645
COL. LA HUERTA,10,35,21,5,0,61,92,1.508196721
COL. EL CARRIZAL NO. 1 B,241,107,144,83,33,367,776,2.114441417
COL. CANTARERO LOPEZ,276,114,194,98,27,433,904,2.087759815
BO. SAUCIQUE,58,24,18,17,14,73,167,2.287671233
COL. RES. LUINIZA,0,16,2,0,1,19,24,1.263157895
COL. 14 DE ENERO,80,32,17,31,15,95,219,2.305263158
BO. SOLEDAD NO.2,32,37,20,14,3,74,131,1.77027027
RES. ROBLE OESTE II ETAPA,131,29,79,44,11,163,363,2.226993865
COL. EL HATILLO,233,34,38,64,55,191,522,2.732984293
COL. NUEVA ERA,59,15,23,11,14,63,150,2.380952381
COL. ERA NO. 2,259,110,160,91,21,382,787,2.060209424
COL. PLANES DEL MOGOTE,17,49,10,9,3,71,108,1.521126761
COL. CAMPO CIELO,358,217,174,110,57,558,1123,2.012544803
COL. LAS CASITAS,143,199,83,48,25,355,609,1.715492958
COL.PUENTE DE LOARQUE O COLINAS DE,58,13,26,14,10,63,147,2.333333333
CASERIO EL PORTILLO,6,3,1,4,0,8,17,2.125
BO. EL CHORIZO,15,10,7,2,4,23,46,2
COL. VICENTE LOPEZ,7,9,5,2,1,17,29,1.705882353
COL. LA FUENTE II ETAPA,3,46,12,2,0,60,76,1.266666667
COL. LOS PERIODISTAS,22,10,3,2,8,23,54,2.347826087
RES. VILLAS EUCALIPTO,10,4,7,4,0,15,30,2
BO. LA ESTANZUELA,13,5,8,4,1,18,37,2.055555556
COL. NORA DE MELGAR,22,11,8,9,1,29,58,2
BO. LOS ZUNIGA,10,4,4,3,1,12,25,2.083333333
BO. EL ALTO DE LA JOYA,34,10,29,6,1,46,90,1.956521739
BO. EL CERRITO,89,22,58,23,3,106,219,2.066037736
COL. HERMANOS REINA,51,27,4,15,10,56,120,2.142857143
COL. RES. MONTE CARLOS,33,4,13,12,1,30,70,2.333333333
BO. SANTA ROSA,127,29,82,30,5,146,303,2.075342466
COL. VISTA HERMOSA DEL NORTE,89,40,18,18,18,94,202,2.14893617
COL. EL PROGRESO NO. 1,108,71,37,21,16,145,272,1.875862069
COL. SAN LORENZO,38,30,21,4,5,60,104,1.733333333
COL. ALEMANIA NO. 1,92,47,53,19,2,121,218,1.801652893
COL. EL CARRIZAL  NO. 1 - A,150,102,54,28,15,199,354,1.778894472
COL. ALTAMIRA,32,18,4,2,8,32,64,2
RES. LIQUIDAMBAR,0,58,0,0,0,58,58,1
COL.1RO DE DICIEMBRE,478,241,131,81,60,513,986,1.92202729
BO. LAS BRISAS,291,82,109,54,23,268,554,2.067164179
COL. LOMAS DEL GUIJARRO  SUR,462,137,88,83,66,374,826,2.20855615
COL. ALTOS DE MIRAMESI,39,26,13,6,4,49,86,1.755102041
RES. ROBLE ESTE I ETAPA,75,37,18,16,7,78,149,1.91025641
COL. SAN JUAN DE PUNTA ARENA,57,23,24,7,5,59,112,1.898305085
BO. CONCEPCION,131,57,36,32,7,132,253,1.916666667
RES. VILLA LA ORQUIDEA,13,6,3,3,1,13,25,1.923076923
COL. SAN JUAN BOSCO,55,37,11,13,4,65,114,1.753846154
COL. GODOY,86,31,15,12,13,71,149,2.098591549
BO. BURRERA,125,53,38,31,4,126,238,1.888888889
VILLAS DE SAN IGNACIO,14,4,3,3,1,11,23,2.090909091
COL. SANTA ISABEL,40,24,10,5,4,43,75,1.744186047
EL ZARZAL O BETANIA,283,187,95,31,21,334,554,1.658682635
COL. ALEMANIA  NO. 2,58,35,28,8,0,71,115,1.61971831
COL. VILLA SAN ANTONIO O BOQUERON,63,41,21,7,4,73,120,1.643835616
RES. VILLAS DEL MOLINON,21,1,5,3,2,11,28,2.545454545
COL. EL DORADO,16,5,6,0,2,13,25,1.923076923
RES. VILLAS LA ARBOLEDA II ETAPA,7,3,3,1,0,7,12,1.714285714
COL. ZONA MIRAFLORES SUR,3,3,0,1,0,4,6,1.5
ALDEA LA TRAVESIA,1714,819,326,194,172,1511,2741,1.814030443
COMUNIDAD SOCIAL,63,32,9,6,8,55,100,1.818181818
COL. FUERZAS ARMADAS,61,22,17,6,5,50,94,1.88
COL. PEREZ,31,7,7,5,2,21,44,2.095238095
COL. ROSA LINDA,144,82,26,21,10,139,237,1.705035971
RES. COPA CABANA,45,15,11,3,5,34,66,1.941176471
COL. VILLA UNION,718,302,132,76,65,575,1054,1.833043478
BO. BRISAS DEL PICACHO,96,91,27,6,5,129,183,1.418604651
COL. ERA NO. 1,375,151,99,51,14,315,558,1.771428571
COL. CIUDAD NUEVA,82,55,11,6,9,81,131,1.617283951
COL. LAS VEGAS DEL CARRIZAL,49,43,13,4,2,62,89,1.435483871
RES. VILLAS LIQUIDAMBAR,3,0,2,0,0,2,4,2
RES. LAS HADAS III ETAPA,105,35,12,12,11,70,139,1.985714286
COL.SAGASTUME NO.2,197,85,37,11,21,154,276,1.792207792
BO. LA SOLEDAD,209,120,46,18,12,196,314,1.602040816
COL. NUEVOS HORIZONTES,196,95,42,21,9,167,278,1.664670659
COL. 23 DE JUNIO,200,121,46,22,5,194,299,1.541237113
COL. ALTOS DE SAN ISIDRO,70,38,14,6,4,62,100,1.612903226
COL. RES. PINARES,15,2,5,2,0,9,18,2
BO. LOS HIGUEROS,11,5,2,2,0,9,15,1.666666667
BO. EL CENTRO,191,62,43,22,7,134,242,1.805970149
COL. FATIMA,188,88,41,16,9,154,254,1.649350649
COL. MILENIUM,77,37,15,5,5,62,102,1.64516129
COL. EL CARRIZAL NO. 2,727,286,138,67,40,531,923,1.738229755
COL. LUIS CORDOVA O CAPRISA,42,45,13,1,0,59,74,1.254237288
COL. QUEZADA,70,25,5,1,11,42,82,1.952380952
COL. 19 DE SEPTIEMBRE,226,128,52,10,13,203,314,1.54679803
COL. LINCOCN,146,56,18,13,12,99,179,1.808080808
CONDOMINIOS MONTE VISTA,5,4,2,0,0,6,8,1.333333333
COL. RES. LAS VEGAS,11,3,2,2,0,7,13,1.857142857
COL. BRASILIA,49,47,12,3,0,62,80,1.290322581
COL. NUEVA PROVIDENCIA,50,26,11,5,1,43,67,1.558139535
COL. LOMAS DEL NORTE,571,218,60,63,39,380,683,1.797368421
BO. EL CARRIZAL,51,19,11,6,1,37,63,1.702702703
COL. PREDIOS DEL RECREO,563,167,148,52,13,380,671,1.765789474
BO. SAN RAFAEL,124,23,44,9,1,77,142,1.844155844
COL. LA FELICIDAD,80,53,15,6,2,76,109,1.434210526
RES. VILLA SANTA CRISTINA,14,16,1,0,1,18,22,1.222222222
COL. SAN JOSE DE LOARQUE,181,67,37,15,6,125,210,1.68
EL PICACHITO,302,142,42,29,12,225,361,1.604444444
RES. LAS CASCADAS II ETAPA,26,9,0,5,1,15,28,1.866666667
COL. 28 DE MARZO,501,233,95,51,7,386,604,1.564766839
BO. MIRAFLOR,51,15,3,4,5,27,53,1.962962963
COL. SUPERACION,60,21,7,2,6,36,65,1.805555556
COL. LA SOSA,623,196,113,49,28,386,681,1.764248705
COL. VENECIA,255,87,55,17,9,168,284,1.69047619
COL.LUIS ANDRES ZUNIGA,235,82,38,17,12,149,257,1.724832215
BO. EL VASILON,19,9,3,1,1,14,22,1.571428571
COL. ZUNLACAL,2,4,0,0,0,4,4,1
VILLA SANTA MARGARITA,155,49,27,17,3,96,166,1.729166667
RES. ROBLE OESTE III ETAPA,81,16,18,6,3,43,82,1.906976744
COL. MATAMOROS,43,44,10,0,0,54,64,1.185185185
COL. JAPON,169,67,20,16,6,109,179,1.642201835
RES. VILLAS LA ARBOLEDA I ETAPA,8,3,3,0,0,6,9,1.5
COL. MELGAR CASTRO,39,18,6,3,1,28,43,1.535714286
COL. FLOR NO.1,597,304,84,36,22,446,668,1.497757848
COL. ESPIRITU SANTO,57,70,8,0,0,78,86,1.102564103
COL. ISRAEL NORTE,271,132,52,14,6,204,302,1.480392157
COL. GUAMILITO,87,30,7,9,4,50,87,1.74
COL. FLOR NO.2,222,134,45,10,2,191,262,1.371727749
COL. JARDINES DEL NORTE,58,17,1,8,3,29,55,1.896551724
COL. FLOR DEL CAMPO,1604,821,275,88,36,1220,1779,1.458196721
COL. SAN BUENA VENTURA,299,198,51,14,3,266,354,1.330827068
COL. MIRADOR DE SAN ISIDRO,98,45,18,4,3,70,105,1.5
BO. CENTRO DE TEGUCIGALPA,28,34,1,0,1,36,40,1.111111111
COL. SAGASTUME NO.1,301,118,49,19,9,195,309,1.584615385
COL. LAS TORRES,756,407,124,40,15,586,835,1.424914676
COL. NUEVA ESPERANZA,542,221,86,26,21,354,555,1.56779661
COL. 11 DE JUNIO O SUAZO CORDOVA,234,117,31,17,5,170,250,1.470588235
COL. 13 DE JULIO,126,51,25,10,0,86,131,1.523255814
RESIDENCIAL QUINTA BELLA,22,6,3,3,0,12,21,1.75
COL. LAS CRUCITAS,65,12,8,6,3,29,58,2
COL. VISTA HERMOSA,389,168,59,28,8,263,402,1.52851711
BARRIO CONCEPCION,27,20,3,2,0,25,32,1.28
BO. LA CHIVERA,69,39,17,1,0,57,76,1.333333333
VILLAS ALICANTES,10,8,2,0,0,10,12,1.2
BO. LA MERCED,7,2,0,0,1,3,6,2
RES. LA ESTANCIA(AGREGADA SEGMENTAC,4,0,0,1,0,1,3,3
COL. GRACIAS A DIOS,187,97,29,5,6,137,194,1.416058394
COL. TEPEYAC,236,42,30,21,9,102,201,1.970588235
COL. JARDINES DEL CARRIZAL,89,43,9,8,1,61,89,1.459016393
BO. LA CONCORDIA,58,10,1,2,7,20,46,2.3
COL. EL MANANTIAL,49,30,3,5,0,38,51,1.342105263
COL. LA TRINIDAD,478,197,72,25,8,302,448,1.483443709
BO. LA GRANJA,234,64,31,13,9,117,201,1.717948718
BO. EL PASTEL,104,74,16,2,0,92,112,1.217391304
COL. LOMAS DE LA FLORIDA,77,12,4,8,4,28,60,2.142857143
BO. LOS GIRASOLES,20,11,3,1,0,15,20,1.333333333
ZONA LLANOS DEL POTRERO,22,19,3,0,0,22,25,1.136363636
COL. LOS OLMOS,36,26,3,2,0,31,38,1.225806452
COL.ALTOS DE SAN FRANCISCO,415,230,48,17,7,302,405,1.341059603
COL. JOSE SIMON AZCONA,78,29,6,5,3,43,68,1.581395349
COL. RAFAEL LEONARDO CALLEJAS,294,144,37,13,5,199,277,1.391959799
COL. LOS PROCEDERES,50,8,1,1,6,16,37,2.3125
BO. EL EDEN No 2,181,60,25,6,7,98,156,1.591836735
COL. SANTA EDUVIGES,198,93,22,7,6,128,182,1.421875
COL. SAN MARTIN,174,94,28,6,0,128,168,1.3125
BO. LA CABAÑA,415,165,25,17,23,230,358,1.556521739
COL. MODESTO RODAS ALVARADO,159,94,22,3,2,121,155,1.280991736
COL. AYESTAS,712,419,97,18,6,540,691,1.27962963
COL. CRUZ ROJA,238,127,19,3,11,160,218,1.3625
COL. ROBERTO SUAZO CORDOVA,143,73,20,5,1,99,132,1.333333333
COL. EL  PEDERNAL,128,71,13,6,1,91,119,1.307692308
COL. SANTA ISABEL NO.2,92,33,7,3,5,48,76,1.583333333
COL. VIEJA SANTA ROSA,56,19,8,4,0,31,47,1.516129032
COL. LA FUENTE,144,88,17,5,0,110,137,1.245454545
COL. LA UNION,119,42,18,6,1,67,100,1.492537313
COL. TILOARQUE NORTE,11,5,0,0,1,6,9,1.5
COL. ALTOS DE SAN JOSE,77,14,3,5,5,27,55,2.037037037
BARRIO EL GUAYABAL,44,22,4,0,2,28,38,1.357142857
COL. LAS BRISAS,306,119,19,17,10,165,248,1.503030303
RES. VILLAS COLONIAL,33,20,2,2,0,24,30,1.25
BO. LA ESTRELLA,97,41,13,5,0,59,82,1.389830508
RES. VILLAS OESTE,14,3,4,0,0,7,11,1.571428571
COL. OSCAR CASTRO TEJEDA,88,34,8,3,3,48,71,1.479166667
COL. 14 DE MARZO,747,318,100,18,13,449,624,1.389755011
COL. NUEVA OROCUINA,159,68,14,9,2,93,131,1.408602151
BO. BELLA VISTA,704,340,86,23,5,454,601,1.323788546
COL. LOS PINOS BOLSA MARITANA,52,25,10,0,0,35,45,1.285714286
COL. RES. LARA NORTE,48,5,0,2,5,12,31,2.583333333
RES. VILLA REAL,17,12,2,0,0,14,16,1.142857143
COL. ALTOS DE LOS LAURELES,137,78,22,0,0,100,122,1.22
COL.LOS ALPES,143,51,8,5,7,71,110,1.549295775
RES. TONCONTIN,113,31,6,5,6,48,82,1.708333333
COL. VILLA LOS LAURELES ( FLOR DEL,356,198,39,9,1,247,307,1.24291498
BO. SIPILE,475,238,47,10,7,302,390,1.291390728
COL. BRISAS DEL NORTE,256,119,16,11,5,151,204,1.350993377
COL. ALTOS DE LA PRIMAVERA,60,28,9,1,0,38,49,1.289473684
COL. LOS ALMENDROS,28,19,3,0,0,22,25,1.136363636
COL. ZONA DE LA CLINICA PERIFERICA DEL IHSS NO.2,25,11,3,1,0,15,20,1.333333333
BO. LA LOMA II ETAPA O CONDOMINIOS CIUDAD MILANO,8,5,1,0,0,6,7,1.166666667
COL.DE LA VEGA,3,3,0,0,0,3,3,1
RES. EL PORTAL DE LAS FLORES N°3,1,1,0,0,0,1,1,1
BO. LOS PROFESORES,70,37,9,1,0,47,58,1.234042553
COL. LA INDEPENDENCIA,611,331,49,15,7,402,502,1.248756219
COL. SAN CARLOS,28,19,1,1,0,21,24,1.142857143
COL. TRES DE MAYO,1277,659,128,32,4,823,1027,1.247873633
COL. SAN JOSE,69,34,9,1,0,44,55,1.25
COL. ESTADOS UNIDOS,289,91,33,10,5,139,207,1.489208633
COL.NUEVA EDEN,104,29,1,5,6,41,70,1.707317073
COL. ALTOS DE LOARQUE,372,180,42,6,2,230,290,1.260869565
"COL. RES, LOS ZORZALES",15,11,1,0,0,12,13,1.083333333
COL. 21 DE FEBRERO,921,477,90,6,12,585,723,1.235897436
RES. PRADO VERDE,16,7,1,1,0,9,12,1.333333333
COL. OBRERA,482,213,48,15,2,278,362,1.302158273
BO. VIERA,122,45,13,3,2,63,88,1.396825397
RES. ALTOS DE MIRAFLORES SUR I ETAPA,67,25,5,3,1,34,48,1.411764706
COL.EL RETIRO,291,129,31,5,3,168,218,1.297619048
BO. SAN JUAN DE DIOS,62,30,4,3,0,37,47,1.27027027
COL. LAS MERCEDES,773,403,80,12,0,495,599,1.21010101
COL. NUEVA SANTA ROSA,274,134,24,7,1,166,207,1.246987952
BO. MIRAMESI,102,16,6,5,5,32,63,1.96875
COL. IZAGUIRRE,518,260,50,10,1,321,394,1.22741433
COL. EL SOCORRO,19,11,2,0,0,13,15,1.153846154
COL. JARDINES DE SAN JOSE,57,29,5,0,1,35,43,1.228571429
BO. LAS CRUCITAS,643,337,64,7,1,409,490,1.19804401
COL.INDEPENDIENTE (ANTES EL PORTILL,34,16,3,1,0,20,25,1.25
COL.VILLAS COLONIALES ALTOS DE MIRA,30,23,1,0,0,24,25,1.041666667
BO. LA LOMA,10,1,1,1,0,3,6,2
COL.  HAMBURGO,7,6,0,0,0,6,6,1
COL. ALTOS DEL PEDREGALITO,98,52,11,0,0,63,74,1.174603175
BO.JARDINES DE CASAMATA,31,23,1,0,0,24,25,1.041666667
COL. JUAN LINDO,64,28,7,1,0,36,45,1.25
COL. SAN EUGENIO,26,10,4,0,0,14,18,1.285714286
COL.LOS ALPES B/16,14,3,3,0,0,6,9,1.5
COL. LOS CENTENOS,149,68,11,2,2,83,104,1.253012048
COL. NUEVAS DELICIAS,52,31,4,0,0,35,39,1.114285714
COL. LA PEÑA,971,453,77,16,7,553,683,1.235081374
URBANIZACION AGUA DULCE,78,17,4,2,4,27,47,1.740740741
COL. OSCAR A. FLORES,396,175,34,9,1,219,274,1.251141553
COL. EL PORVENIR,302,144,22,5,2,173,211,1.219653179
COL. RUBEN DARIO,85,14,11,5,0,30,51,1.7
COL.SANTA CECILIA,394,174,33,5,3,215,267,1.241860465
COL. SMITH NO. 2,92,31,9,2,1,43,59,1.372093023
COL.EL CONTADOR,62,12,4,4,1,21,36,1.714285714
COL. GUILLEN,690,188,70,25,5,288,423,1.46875
COL. COFRADIA,51,25,5,0,0,30,35,1.166666667
COL. RODRIGUEZ,647,337,47,4,1,389,447,1.149100257
COL. SANTA BARBARA,38,7,1,0,3,11,21,1.909090909
COL. VILLA SAN ROQUE,4,3,0,0,0,3,3,1
COL. LA TRINIDAD,116,60,7,0,1,68,78,1.147058824
COL. EL ROSARIO,404,188,27,6,1,222,264,1.189189189
"RES. LOS HIDALGOS CICUITO I, II Y III",221,49,6,6,11,72,123,1.708333333
BO. PUNTA CALIENTE,41,24,2,0,0,26,28,1.076923077
COL.LOS ALPES #2,101,32,10,3,0,45,61,1.355555556
COL. MODELO,145,29,8,5,5,47,80,1.70212766
BO. LEMPIRA,262,137,12,1,2,152,172,1.131578947
BO. EL RINCON,135,53,8,2,2,65,83,1.276923077
COL. SAN FRANCISCO,774,327,50,14,4,395,485,1.227848101
COL. MARICHAL,49,14,6,1,0,21,29,1.380952381
BO. SAN JORGE,33,10,1,1,1,13,19,1.461538462
COL. LA PRADERA,559,213,31,9,9,262,338,1.290076336
RES. VENECIA I ETAPA,162,38,8,8,3,57,90,1.578947368
COL. DIVANNA,369,160,23,6,1,190,228,1.2
COL. BRISAS DE OLANCHO,411,138,27,11,4,180,241,1.338888889
COL. 30 DE NOVIEMBRE,345,124,24,8,2,158,204,1.291139241
COL. CANADA,309,139,23,2,0,164,191,1.164634146
COL. BRISAS DEL VALLE,249,112,21,0,0,133,154,1.157894737
COL. LOS SORZALES NO.1,187,82,10,4,0,96,114,1.1875
COL. LA ROSA,498,227,30,1,4,262,306,1.167938931
COL. LOMA LINDA NORTE,281,34,17,18,5,74,142,1.918918919
COL. ALTOS DE LA CABAÑA,121,33,5,1,5,44,66,1.5
URBANIZACION LA CUMBRE,95,24,8,0,3,35,52,1.485714286
BO.  SIMON BOLIVAR,66,25,1,1,2,29,38,1.310344828
COL. ALTOS DE LA SOSA,10,4,1,0,0,5,6,1.2
COL. CAMPAÑA ARRIBA,6,4,0,0,0,4,4,1
UNIVERSIDAD ESTE,8,1,0,1,0,2,4,2
COL. SEMPE,162,54,14,2,1,71,92,1.295774648
COL. SABANAGRANDE,119,37,12,2,0,51,67,1.31372549
BO. SAN PABLO,629,239,46,4,5,294,363,1.234693878
BO. SAN ISIDRO,50,19,5,0,0,24,29,1.208333333
COL. IBERIA,494,192,29,6,4,231,284,1.229437229
COL. LAS PALMAS,932,413,53,5,4,475,550,1.157894737
RES. ALTOS DE MIRAFLORES SUR III ETAPA,101,39,8,1,0,48,58,1.208333333
COL. SAN LUIS,85,35,5,0,1,41,49,1.195121951
COL. LA ESPERANZA,533,204,36,8,1,249,304,1.220883534
BO.  EL CHILE,471,210,30,1,1,242,277,1.144628099
COL. LUIS ANDRES ZUNIGA II ETAPA,325,115,17,5,4,141,180,1.276595745
RES. VILLA DE LAS HADAS,29,7,1,2,0,10,15,1.5
AVE. LA PAZ,9,3,1,0,0,4,5,1.25
COL.LOMA SUR,24,9,0,0,1,10,13,1.3
COL. SUYAPA,412,210,15,1,0,226,243,1.075221239
RES. ZARAHENLA,90,14,1,5,3,23,43,1.869565217
RES.EL TRAPICHE,238,42,10,7,8,67,115,1.71641791
BO. VILLA EL CIRUELO,46,21,1,1,0,23,26,1.130434783
COL.ALTOS DE LA JOYA,36,19,1,0,0,20,21,1.05
BO. JACALEAPA,18,5,0,0,1,6,9,1.5
RES. AZULEJOS DE SAN IGNACIO,6,1,1,0,0,2,3,1.5
COL.JESUS AGUILAR PAZ,52,8,5,1,1,15,25,1.666666667
COL. LARA,91,30,1,1,3,35,47,1.342857143
COL. MONTEREY,718,305,41,2,1,349,397,1.137535817
BO. LA PAGODA,215,76,11,4,1,92,114,1.239130435
BO. ALTOS DEL BOSQUE O 13 DE FEBRER,62,34,1,0,0,35,36,1.028571429
CONDOMINIOS VILLA CASTELAMAR,18,8,1,0,0,9,10,1.111111111
BO. MORAZAN,586,219,20,5,9,253,310,1.225296443
RES. EL SAUCE,60,20,1,3,0,24,31,1.291666667
TRAMO 21 DE OCTUBRE,13,5,1,0,0,6,7,1.166666667
COL. SANTA ISABEL O PALMAS OESTES,260,90,15,4,1,110,136,1.236363636
COL. LA LAGUNA,141,69,5,0,0,74,79,1.067567568
COL. ALAMEDA,173,63,6,1,3,73,90,1.232876712
COL. LAS CANTERAS,118,44,6,2,0,52,62,1.192307692
COL. LOMA VERDE NORTE,30,12,2,0,0,14,16,1.142857143
BO. SALIDA A VALLE DE ANGELES,17,4,0,0,1,5,8,1.6
COL. VILLAS SANTA MONICA,7,4,0,0,0,4,4,1
RES. PALMA REAL,242,75,6,6,4,91,121,1.32967033
BO. GUACERIQUE,68,26,1,1,1,29,35,1.206896552
BO. EL SOCORRO,202,88,5,3,0,96,107,1.114583333
COL. BELLA VISTA NORTE,138,55,7,1,0,63,72,1.142857143
BO. LA JOYA 1,9,5,0,0,0,5,5,1
COL. LAS VEGAS 12,9,5,0,0,0,5,5,1
BO. EL BOSQUE,746,281,38,3,3,325,378,1.163076923
COL. BENDECK,121,49,5,1,0,55,62,1.127272727
RES. ALTOS DE MIRAFLORES SUR II ETAPA,39,13,1,0,1,15,19,1.266666667
BO. EL PEDREGALITO,468,173,23,4,1,201,235,1.169154229
COL. LOMA LINDA SUR,175,58,10,0,2,70,86,1.228571429
COL. LIVERPOOL,152,57,6,1,1,65,76,1.169230769
COL. BETANIA,179,50,1,1,7,59,83,1.406779661
COL. RIVAS,93,34,6,0,0,40,46,1.15
"COL. RES. VILLA SUYAPA (SECTOR I,II",431,90,24,12,5,131,194,1.480916031
COL. RES. LA HACIENDA (PROYECTO,125,46,3,3,0,52,61,1.173076923
BO. SAN CRISTOBAL,130,46,5,1,1,53,63,1.188679245
COL. LAS MINITAS,43,20,1,0,0,21,22,1.047619048
COL. ALTOS DE TILOARQUE,153,32,8,0,5,45,68,1.511111111
COL. TOROCAGUA,859,339,33,1,4,377,424,1.124668435
COL. COOPERATIVA LAS MERCEDES,24,10,1,0,0,11,12,1.090909091
RES.EUCALIPTO,24,10,1,0,0,11,12,1.090909091
COL. ISRAEL SUR,145,31,8,6,0,45,65,1.444444444
RES. SANTA CRUZ,110,36,3,2,1,42,52,1.238095238
COL. POLICARPO PAZ GARCIA,465,164,24,4,0,192,224,1.166666667
CASAMATA,157,55,5,2,1,63,75,1.19047619
COL. ALTOS DE LA DIVANNA,122,49,4,1,0,54,60,1.111111111
BO. SAN FELIPE,32,11,0,0,1,12,15,1.25
BO. GUANACASTE,316,125,12,2,0,139,155,1.115107914
COL. NUEVA AMANECER,106,30,6,1,1,38,49,1.289473684
BO. PERPETUO SOCORRO,548,232,20,0,0,252,272,1.079365079
COL. VILLA DELMY,157,56,8,1,0,65,75,1.153846154
COL. LA PROVIDENCIA,103,41,3,1,0,45,50,1.111111111
BO. EL REPARTO,1317,431,59,9,10,509,616,1.21021611
BARRIO AGUA DULCE 1,56,26,1,0,0,27,28,1.037037037
COL. CERRITO,94,45,1,0,0,46,47,1.02173913
BO. BELEN,622,237,23,3,1,264,296,1.121212121
BO. EL CALVARIO,124,52,4,0,0,56,60,1.071428571
RES. VILLAS LAS MARIAS,50,12,3,0,1,16,22,1.375
COL. RES. LOS MANGOS,9,2,1,0,0,3,4,1.333333333
RES. PARIS,7,1,1,0,0,2,3,1.5
COL. TOWNHOUSE VILLA SOL,5,0,1,0,0,1,2,2
COL. ZAPOTE CENTRO,411,145,17,3,1,166,192,1.156626506
BO. CAMAGUARA,171,62,7,0,1,70,80,1.142857143
LA CASCADA,138,46,5,1,1,53,63,1.188679245
COL. SANTA FE,382,135,18,2,0,155,177,1.141935484
BO. EL MANCHEN,609,214,18,6,3,241,280,1.161825726
RES. VENECIA II ETAPA,117,38,4,1,1,44,53,1.204545455
COL. SMITH  NO. 1,179,61,5,2,1,69,81,1.173913043
COL. MONSEÑOR FIALLOS,341,130,12,0,1,143,158,1.104895105
COL. LA HAYA,248,87,13,0,0,100,113,1.13
BO. LA FUENTE,110,38,6,0,0,44,50,1.136363636
BO. LA ESPERANZA,86,23,5,0,1,29,37,1.275862069
RES. CIUDAD DEL ANGEL,119,29,3,5,0,37,50,1.351351351
BO. EL COCO,117,41,4,1,0,46,52,1.130434783
COL. ALTOS DE MIRAMONTES,293,105,13,0,0,118,131,1.110169492
"COL. CENTROAMERICA ( ETAPA I, II )",313,114,13,0,0,127,140,1.102362205
COL. SAN MIGUEL,1283,418,50,9,4,481,561,1.166320166
COL. LOMA LAS MINITAS,158,43,7,2,1,53,67,1.264150943
BO. VILLA ADELA,333,119,9,2,1,131,147,1.122137405
MONTES DE SINAI,311,93,8,1,5,107,132,1.23364486
COL. PALMIRA,153,45,4,4,0,53,65,1.226415094
COL. LA POPULAR,203,77,5,1,0,83,90,1.084337349
COL. PALERMO,46,21,0,0,0,21,21,1
COL. RES. LUIS LANDA,92,38,0,1,0,39,41,1.051282051
"COL. KENNEDY ( ZONA 1,2,3,4,5,6,)",3203,1210,60,13,8,1291,1401,1.085205267
RES. LA ARBOLEDA,128,32,4,0,3,39,52,1.333333333
COL. ZAPOTE NORTE,234,93,5,0,0,98,103,1.051020408
COL.ARMANDO CALIDONIO,61,16,3,1,0,20,25,1.25
COL. JARDINES DE TONCONTIN,348,102,19,0,1,122,144,1.180327869
COL. ALTOS DEL MILAGRO,78,27,3,0,0,30,33,1.1
RES. VILLAS PALMERAS DE SAN IGNACIO,93,31,4,0,0,35,39,1.114285714
COL. EL COUNTRY,120,36,5,1,0,42,49,1.166666667
BO. CONCEPCION,452,137,16,1,3,157,184,1.171974522
COL.LOMAS DE LOARQUE,53,18,2,0,0,20,22,1.1
RES. ALEMAN,639,174,21,2,8,205,254,1.23902439
BO. LAS DELICIAS,102,36,0,2,0,38,42,1.105263158
RES. EL PORTAL DE LAS FLORES N°1,14,6,0,0,0,6,6,1
RES. ALESSA,7,3,0,0,0,3,3,1
RES. FLORIDA II ETAPA,7,3,0,0,0,3,3,1
COL. HENRY MERRIAN,102,36,3,0,0,39,42,1.076923077
RES. TULIPANES,34,12,1,0,0,13,14,1.076923077
COL. CRISTOBAL DIAZ,61,22,0,1,0,23,25,1.086956522
COL. MIRAFLORES,1136,357,20,3,12,392,454,1.158163265
BO. JARDIN DE LAS MERCEDES,224,77,7,0,0,84,91,1.083333333
COL. JACARANDA,25,8,1,0,0,9,10,1.111111111
COL. PEDREGAL DE SAN JOSE,854,266,28,4,1,299,338,1.130434783
COL. MODESTO RODAS ALVARADO,285,90,10,1,0,101,113,1.118811881
COL. LAS VEGAS 172,56,23,0,0,0,23,23,1
COL. REPUBLICA DE VENEZUELA,417,130,11,2,1,144,162,1.125
COL. FALDAS DEL PEDREGAL,273,73,8,2,2,85,103,1.211764706
COL. VICTOR  F. ARDON,232,91,1,0,0,92,93,1.010869565
BO. SAN RAFAEL,120,42,1,1,0,44,47,1.068181818
COL. LA FRATERNIDAD,127,39,5,0,0,44,49,1.113636364
COL. JARDINES DE LOARQUE,392,151,1,1,0,153,156,1.019607843
COL. SAN JOSE DE LA MONTAÑA,178,54,4,2,0,60,68,1.133333333
RES. VILLA SAN JORGE,25,1,0,1,1,3,8,2.666666667
COL. LA CAMPAÑA O MAYA CENTRO,10,4,0,0,0,4,4,1
COL. RES. LAS COLINAS,644,213,16,0,1,230,249,1.082608696
COL. PUEBLO NUEVO,226,63,8,2,0,73,85,1.164383562
COL. SANTA ANITA O EL QUEBRACHAL,41,9,3,0,0,12,15,1.25
COL. FEHCOVIL,62,22,1,0,0,23,24,1.043478261
BO. LA PEDRERA NO.1,24,7,1,0,0,8,9,1.125
BO. LOS DOLORES,62,19,2,0,0,21,23,1.095238095
BO. PUEBLO NUEVO,62,19,2,0,0,21,23,1.095238095
BO. EL EDEN No 1,111,23,5,2,0,30,39,1.3
BO. LA RONDA,180,60,2,1,0,63,67,1.063492063
RES. LAS UVAS (NOTA: PFF),121,23,1,0,4,28,41,1.464285714
COL. BELLA ORIENTE,479,135,5,2,5,147,171,1.163265306
COL. VILLA NELITA,44,7,4,0,0,11,15,1.363636364
COL. EL HOGAR,351,119,3,0,1,123,129,1.048780488
COL. MIRAMONTES,228,60,1,2,3,66,80,1.212121212
COL. RES. RUBEN ANTUNEZ,19,7,0,0,0,7,7,1
COL. AURORA NO.1,358,101,13,0,0,114,127,1.114035088
COL. LAS VEGAS DEL COUNTRY,246,83,1,0,1,85,89,1.047058824
COL.MONTE FRESCO,516,134,11,5,2,152,179,1.177631579
URBANIZACION LOMA VERDE,44,9,3,0,0,12,15,1.25
COL. VISTA HERMOSA,11,4,0,0,0,4,4,1
COL. MONTELIMAR,72,26,0,0,0,26,26,1
COL. ARTURO QUESADA,1300,344,31,7,4,386,443,1.147668394
COL. BOLIVAR,46,14,1,0,0,15,16,1.066666667
COL. RES. RIO ALTO,17,6,0,0,0,6,6,1
BO. EL OBELISCO,20,7,0,0,0,7,7,1
BO. GUADALUPE,695,196,13,4,0,213,234,1.098591549
COL. EL PROGRESO NO.2,53,10,2,1,0,13,17,1.307692308
COL. ALTOS DE LAS VEGAS,27,7,1,0,0,8,9,1.125
BO. LA LEONA,327,89,6,1,1,97,108,1.113402062
"COL. MIRAFLORES SUR II, III, IV Y V ETAPA",49,7,2,0,1,10,15,1.5
BO. COLINAS,60,18,1,0,0,19,20,1.052631579
COL. SAN ANGEL,647,206,5,0,0,211,216,1.023696682
COL. VILLA ESPAÑOLA,69,16,3,0,0,19,22,1.157894737
BO. EL OLVIDO,49,14,1,0,0,15,16,1.066666667
COL. ALTOS DE LA MAYANGLE,49,14,1,0,0,15,16,1.066666667
RES. LA GRAN VILLA,16,3,1,0,0,4,5,1.25
CONDOMINIOS RIVERA NO.2,15,0,0,0,1,1,4,4
COL. HOLYWOOD,9,3,0,0,0,3,3,1
RES. HAMBURGO,9,3,0,0,0,3,3,1
COL. CERRO GRANDE,2621,665,68,8,3,744,837,1.125
BO. LA HOYA,115,28,2,0,1,31,36,1.161290323
COL. LAS VEGAS FECESITLICH,39,8,2,0,0,10,12,1.2
COL.SANTA ANA,37,12,0,0,0,12,12,1
BO. TILOARQUE  SECTOR I,110,26,4,0,0,30,34,1.133333333
BO. LA PLAZUELA,101,30,1,0,0,31,32,1.032258065
COL. GUAYMURAS,202,62,1,0,0,63,64,1.015873016
COL.VALENCIA,88,28,0,0,0,28,28,1
COL. RES. LOMA ALTA,22,7,0,0,0,7,7,1
RES. LAS UVAS II ETAPA,144,36,4,0,0,40,44,1.1
BO. LA ZARAGOSA,84,20,1,1,0,22,25,1.136363636
COL. LA REFORMA,78,24,0,0,0,24,24,1
COL. HUMUYA,183,47,4,0,0,51,55,1.078431373
COL. LINTON,73,20,1,0,0,21,22,1.047619048
COL. INTERAMERICANA,97,22,1,0,1,24,28,1.166666667
LOTIFICACION ALTOS DE LA LOMA,51,13,1,0,0,14,15,1.071428571
COL. ALTOS DE ELVEL,10,3,0,0,0,3,3,1
RES. EL PORTAL DE LAS FLORES N°2,10,3,0,0,0,3,3,1
COL. HATO DE ENMEDIO (SECTOR 1 AL 1,3081,817,31,2,4,854,901,1.055035129
COL. SAN JOSE DE LA PEÑA,417,116,1,0,1,118,122,1.033898305
COL. 21 DE OCTUBRE,601,159,8,0,0,167,175,1.047904192
ALDEA LA  JOYA,507,122,6,1,2,131,145,1.106870229
RES. EL DORADO,269,50,8,3,0,61,75,1.229508197
COL. GRANADA,229,55,5,0,0,60,65,1.083333333
COL. RES. LAS HADAS,625,114,7,2,9,132,170,1.287878788
COL. LA JOYA,829,191,16,2,1,210,233,1.10952381
COL. ELVEL,80,23,0,0,0,23,23,1
COL. 15 DE SEPTIEMBRE,300,79,1,0,1,81,85,1.049382716
COL. RIO GRANDE NORTE,205,53,1,1,0,55,58,1.054545455
LAS HADAS II ETAPA,45,7,1,1,0,9,12,1.333333333
"COL NUEVA ERA ( ETAPA I, II, III )",228,58,3,0,0,61,64,1.049180328
BO. CENTRO DE COMAYAGUELA,260,54,5,1,1,61,71,1.163934426
BO. BUENOS AIRES,569,129,11,2,0,142,157,1.105633803
"COL. UNIVERSIDAD NORTE(I, II ETAPA)",263,33,6,1,5,45,68,1.511111111
COL. RES. LA CAÑADA,732,123,20,4,5,152,195,1.282894737
COL. RES. LAS JOYAS,76,19,1,0,0,20,21,1.05
BO. LAS PALOMAS,50,14,0,0,0,14,14,1
BO. PLANES DE LA LOMA,26,5,1,0,0,6,7,1.166666667
COL. SATELITE,458,119,4,0,0,123,127,1.032520325
COL. LINDA VISTA O PLANES DEL GUIJA,62,15,1,0,0,16,17,1.0625
COL. SANTO DOMINGO,164,34,5,0,0,39,44,1.128205128
BO. MONCADA,40,11,0,0,0,11,11,1
COL. EL JAZMIN,138,33,2,0,0,35,37,1.057142857
COL. AMERICA,492,103,6,3,1,113,128,1.132743363
BO. ABAJO,200,40,6,0,0,46,52,1.130434783
CONDOMINOS RIVIERA,15,4,0,0,0,4,4,1
RES. ALTOS DE VENECIA,56,10,0,0,1,11,14,1.272727273
COL. RIO GRANDE SUR,196,42,0,0,2,44,50,1.136363636
COL. RESIDENCIAL LA CAÑADA,20,3,1,0,0,4,5,1.25
RES. EL MIRADOR,23,6,0,0,0,6,6,1
COL. SUYAPITA,142,37,0,0,0,37,37,1
COL. RESIDENCIAL PLAZA,1116,254,14,1,0,269,285,1.059479554
COL. CENTRO AMERICA OESTE,1779,430,10,2,0,442,456,1.031674208
COL. RES. ALTA VISTA,43,11,0,0,0,11,11,1
COL. RES. HONDURAS,1050,219,13,0,4,236,261,1.105932203
COL..LOMAS DE MIRAFLORES SUR,132,24,4,0,0,28,32,1.142857143
COL. RES. MONTE CARMELO,66,13,0,1,0,14,16,1.142857143
RES. LAS PALMAS,16,4,0,0,0,4,4,1
CONDOMINIOS ANDREWS ROUUS,4,1,0,0,0,1,1,1
"COL. RES. LOS CALPULES ( I,II, ETAP",533,116,6,1,0,123,131,1.06504065
COL. RES. PRADOS UNIVERSITARIOS,806,178,8,0,1,187,198,1.058823529
COL. FRANCISCO MURILLO SOTO,105,17,4,0,0,21,25,1.19047619
"COL. LOMAS DE TILOARQUE ( I, II ETA",420,92,5,0,0,97,102,1.051546392
COL. RES. LAS VEGAS,90,22,0,0,0,22,22,1
COL. RES. CENTRO AMERICA ESTE,771,164,9,1,0,174,185,1.063218391
COL. ALTOS DE LA MAYANGLE,156,31,1,0,1,33,37,1.121212121
COL. SAN JOSE DE LA VEGA,587,125,4,1,1,131,140,1.06870229
COL. EL SITIO,811,155,13,1,1,170,188,1.105882353
RES. SAN JUAN,323,65,3,0,1,69,75,1.086956522
COL.CASANDRA,97,16,1,0,1,18,22,1.222222222
COL. MONTEREY NORTE,108,21,2,0,0,23,25,1.086956522
COL. EL PRADO,185,36,3,0,0,39,42,1.076923077
COL. LOMAS DEL COUNTRY,123,26,1,0,0,27,28,1.037037037
COL. VILLA CENTRO AMERICANA ( III E,282,58,3,0,0,61,64,1.049180328
RES. EL MOLINON,201,40,1,1,0,42,45,1.071428571
COL. RES. CENTRO AMERICA ESTE ( ANE,67,13,1,0,0,14,15,1.071428571
COL. ALTOS DE JARDINES DE LOARQUE,53,12,0,0,0,12,12,1
BO. EL JAZMIN,31,7,0,0,0,7,7,1
COL. RES. TONCONTIN,757,158,5,0,0,163,168,1.030674847
COL. EL MIRADOR,63,14,0,0,0,14,14,1
COL. EL CASTAÑO,20,0,2,0,0,2,4,2
RES. PUERTA DEL SOL,9,2,0,0,0,2,2,1
COL. MIRAFLORES SUR,265,53,1,1,0,55,58,1.054545455
COL. BERNARDO DAZZI,150,33,0,0,0,33,33,1
COL. NUEVO LOARQUE,97,19,1,0,0,20,21,1.05
COL. RES. FRANCISCO MORAZAN,861,158,12,1,0,171,185,1.081871345
COL. VILLAS DEL RIO,72,12,0,1,0,13,15,1.153846154
COL. LINDA VISTA CENTRO,14,3,0,0,0,3,3,1
COL. RES. ALTOS DEL TRAPICHE,615,89,11,5,0,105,126,1.2
COL. ARGENTINA,33,7,0,0,0,7,7,1
COL. BETHEL O DIOS PROVEERA,91,17,1,0,0,18,19,1.055555556
COL. LOMAS DEL CORTIJO,263,46,4,0,0,50,54,1.08
COL. EL TRIANGULO,49,8,1,0,0,9,10,1.111111111
RES. PORTAL DEL BOSQUE,182,31,3,0,0,34,37,1.088235294
COL. LOMAS DEL HATILLO,45,7,1,0,0,8,9,1.125
COL. BRISAS DEL CORTIJO,60,10,1,0,0,11,12,1.090909091
RES. CONDOMINIOS VIERA,59,12,0,0,0,12,12,1
RES. LOS PORTALES,115,21,1,0,0,22,23,1.045454545
"COL RES. LOS GIRASOLES ( I, II, III",315,59,2,0,0,61,63,1.032786885
RES. NORTE FRESCO,46,7,1,0,0,8,9,1.125
COL. RES. BUENA VISTA,15,3,0,0,0,3,3,1
CONDOMINIOS SAIN O NORE,5,1,0,0,0,1,1,1
COL. FLORENCIA SUR,78,13,1,0,0,14,15,1.071428571
COL. EL ALAMO,228,44,0,0,0,44,44,1
COL. LA PRIMAVERA,237,40,1,1,0,42,45,1.071428571
COL. ROMA O COVIDEPROL,47,9,0,0,0,9,9,1
COL. RES. GLORIA A DIOS,21,4,0,0,0,4,4,1
COL. LOARQUE SUR,191,27,0,0,2,29,35,1.206896552
ERENDIDA,59,11,0,0,0,11,11,1
COL. VILLA ESMERALDA,61,9,1,0,0,10,11,1.1
COL. FLORENCIA NORTE,265,45,0,1,0,46,48,1.043478261
COL. LAS VEGAS DEL RIO,77,14,0,0,0,14,14,1
COL. TRES CAMINOS,299,52,1,0,0,53,54,1.018867925
COL. LOMAS DE JACALEAPA,326,59,0,0,0,59,59,1
LOARQUE SUR III ETAPA,69,9,0,1,0,10,12,1.2
COL LOS ANGELES,152,27,0,0,0,27,27,1
RES. VILLAS SAN RAFAEL,17,3,0,0,0,3,3,1
COL. RES. CENTRO AMERICA ESTE (IV E,365,59,0,0,1,60,63,1.05
RES. LOS LIRIOS,46,8,0,0,0,8,8,1
COL. MARIA CRISTINA,53,7,1,0,0,8,9,1.125
COL.LOS ROBLES,651,100,4,1,0,105,111,1.057142857
RES. LA CONCEPCION,135,23,0,0,0,23,23,1
COL. RES. EL JARDIN,18,3,0,0,0,3,3,1
COL. FUENTE MIRAFLORES,12,2,0,0,0,2,2,1
RES. CAMINO AL HATILLO,6,1,0,0,0,1,1,1
VILLA LOS PINOS,6,1,0,0,0,1,1,1
COL. SAN JOSE DE LOS LLANOS,601,97,1,0,0,98,99,1.010204082
COL. RES. VILLA DELMY,80,13,0,0,0,13,13,1
COL. LAS LOMAS DEL GUIJARRO,266,41,1,0,0,42,43,1.023809524
COL. RES. VILLA AURORA,37,6,0,0,0,6,6,1
COL. LA CAMPAÑA,175,28,0,0,0,28,28,1
RES. VILLA MEDITERRANEA,25,4,0,0,0,4,4,1
RES. VILLA LOS OLMOS,25,4,0,0,0,4,4,1
LOMAS DE SAN JOSE II ETAPA,97,12,0,1,0,13,15,1.153846154
COL. EUGENIO MATUTE CANIZALES,116,18,0,0,0,18,18,1
RES. FLORIDA I ETAPA,13,2,0,0,0,2,2,1
COL. RES. MAYA,215,24,4,0,0,28,32,1.142857143
COL. JARDINES DE MIRAFLORES,113,17,0,0,0,17,17,1
COL BERNARDO DAZZI   I  Y  II ETAPA,68,10,0,0,0,10,10,1
COL. RES. LOMAS DE SAN JOSE,152,20,1,0,0,21,22,1.047619048
COL. LAS GRANJITAS,90,13,0,0,0,13,13,1
RES.LOMAS DE NAUVOO,191,23,0,0,1,24,27,1.125
RES. VILLAS LAS ACACIAS,35,5,0,0,0,5,5,1
LOTIFICACION PLAZA JOYA,7,1,0,0,0,1,1,1
COL. ALTOS DE LA JOYA,7,1,0,0,0,1,1,1
RES. VILLA CORINTO,7,1,0,0,0,1,1,1
VILLA SANTA ISABEL,7,1,0,0,0,1,1,1
COL. SANTA CECILIA  NO.1,58,6,1,0,0,7,8,1.142857143
COL. LA ALHAMBRA,22,3,0,0,0,3,3,1
COL. MARADIAGA,92,12,0,0,0,12,12,1
COL . EL HATO O SAN IGNACIO,226,26,0,1,0,27,29,1.074074074
COL. VILLAS DE TILOARQUE,47,6,0,0,0,6,6,1
COL. VILLA LOS REYES,64,8,0,0,0,8,8,1
COL. RES. LEMPIRA,348,36,1,0,1,38,42,1.105263158
RES. ALTOS DE MIRAFLORES SUR,17,2,0,0,0,2,2,1
RES. VIENA,17,2,0,0,0,2,2,1
CONDOMINIOS CASA DORAL,17,2,0,0,0,2,2,1
COL. LOS MOLINOS ( PROYECTO ),140,16,0,0,0,16,16,1
COL. RES. SANTA MARIA,393,38,3,0,0,41,44,1.073170732
COL. ALTOS DE TONCONTIN,98,11,0,0,0,11,11,1
RES.VILLAS UNIVERSITARIAS NO.2,74,8,0,0,0,8,8,1
COL. RES. AEREOPUERTO,37,4,0,0,0,4,4,1
COL. VILLA CENTRO AMERICA,28,3,0,0,0,3,3,1
I.P.M.,79,8,0,0,0,8,8,1
RES. VILLAS DEL MIRADOR,10,1,0,0,0,1,1,1
VILLA FLORENCIA,10,1,0,0,0,1,1,1
COL. RES. ALTOS DE LAS COLINAS,116,11,0,0,0,11,11,1
CONDOMINIOS OLIMPUS,32,3,0,0,0,3,3,1
ROBLE ALTO,80,7,0,0,0,7,7,1
COL. RES. VILLA UNIVERSITARIA I ETA,196,17,0,0,0,17,17,1
COL. CASAVOLA,24,2,0,0,0,2,2,1
COL. SANTO TOMAS,12,1,0,0,0,1,1,1
COL. VIERA,115,9,0,0,0,9,9,1
COL. COVESPUL,86,6,0,0,0,6,6,1
COL. PARCALTAGUA,29,2,0,0,0,2,2,1
COL. RES. MAYA CENTRO,31,2,0,0,0,2,2,1
COL. CIUDAD JARDIN,32,2,0,0,0,2,2,1
COL. INESTROZA,16,1,0,0,0,1,1,1
COL.AURORA NO.2,54,3,0,0,0,3,3,1
RES. VILLA BENETON,18,1,0,0,0,1,1,1
COL. RES. ATLANTIS,20,1,0,0,0,1,1,1
COL. MIRADOR DE LOARQUE,25,1,0,0,0,1,1,1
COL. PAYAQUI,52,2,0,0,0,2,2,1
CONDOMINIOS EL COUNTRY,27,1,0,0,0,1,1,1
COL. RES. MONTE VERDE,73,2,0,0,0,2,2,1
COL. REPARTO MANDOFER,9,0,0,0,0,0,0,0
COL. SAN RAFAEL,21,0,0,0,0,0,0,0
COL. ESTIQUIRIN,2,0,0,0,0,0,0,0
ALDEA S.O.S.,1,0,0,0,0,0,0,0
RES. LOMAS DE CARRARA,8,0,0,0,0,0,0,0
RES. VILLA DANIA,6,0,0,0,0,0,0,0
COL. LOS ENSUEÑOS,5,0,0,0,0,0,0,0
RES. VILLA EVELIN,5,0,0,0,0,0,0,0
COL. VILLAS SAN JOSE,11,0,0,0,0,0,0,0
CONDOMINIOS VILLA SAN DIEGO,7,0,0,0,0,0,0,0
CONDOMINIOS RIVERA NO.1,13,0,0,0,0,0,0,0
CONDOMINIOS VENECIA,11,0,0,0,0,0,0,0
BO. MONTECILLO,5,0,0,0,0,0,0,0
